6
f 3
g 1
G 2
h 4
m 7
r 5
10 10
f f m h m g G G r r
m h f G f r G G h G
G r r g f h G r f h
h r h r G f g r f m
G r g G g g g g g G
g m g r h f G f r f
h g r r m f h r r h
g r G G G g m g g r
G G g g r r g g h r
G m m r g G r m f G
0 0
9 9
